███████████████
█   █         █
█ █ █ ███ ███ █
█ █     █   █ █
█ ████ ██ █ █ █
█    █    █   █
████ ████ ███ █
█             █
█ ███ ███ ███ █
█   █     █   █
█ █ ███ ███ ███
█ █           █
█ ███ ███ ███ █
█            X█
███████████████