# TILE LEGEND
# █ = Wall
#   = Floor
# P = Player Spawn
# z = Zombie Spawn
# X = Exit


███████████████
█P    █   ██  █
███ █ ███ ██ ██
█   █   █     █
█ █████ █ ███ █
█     █ █   █ █
█ ███ █ ███ █ █
█ █   █     █ █
█ █ ███ ███ █ █
█ █     █     █
█ █ █████ █ █ █
█ █ █   █ █ █ █
█ █ █ █ █ █ █ █
█     █   █X  █
███████████████
